30 120
................................**.......................................***................*.**.....*.**..*...........*
...............................*.***....................**.**.............**................**........***.***..........*
..*.......................**.**..**........**..........*..*****.**....*.**..*.........**....**.......*7**.****........*.
..*...............*......*..*....**.......****.......**.**..*****......****........******..*.....**....***.***...***....
.................**....***.................***......******...****.*.....***...***..*****.........**..........*...***....
*.*...............**..****..................**.....****.**...******....******..*...**...........***.........*..****.....
*6.................*.*.*...........................****......******....******..*...*.............*..............**......
*.*..*....................**.......................*****........*......******........***.......**...............***.....
***...*..................*.*...*.*................*****..............**..**.........****.......................*..*.....
.*....***..................*..*****...............*..................*....**........*.**.......................***......
..*..*.*......................*****................*..................*..2*...**...**...*.......................*.......
.......**...................***.5**...........................................**..****.***..............................
......**.......................****..........**.............................*.*.*****.***...............................
......***.....................****.........***.......*....................**...******.*.................................
.....***.................*.....**...........*.*.....**...................*.*.....*.*....................................
....*.*...................*....**........***....*.*.****........*......****.*.......****................................
***......................**..............***.....**.****.......***....**.*.........*.**.................................
***...................*****....*.........**....***.*.***....*.****.....**............**.................................
**...................******...**...................*4***.....*..**......*............**............................*..*.
.....................*****......*...............**..****.............................**...........................*..***
.......**...........****.......*...............*.**..................................**..........................**..***
......****...**9...*.****........................**.................................................*...*..***...*.....*
..*...***...****.*..***........*.**..........**.**........................................*.*.......****..***.........**
..**...*.*..***.*....*.........*.**...........**..........................................***........*...****...........
****..*.*...*****.*..3.......***.*..............*.....**..................................*.*...........*.****..........
****....*....*****..........****..*...................**.....................****..........*.............*****...*......
..**..***1....*..............***.....................****....................******...........................*..**....*
.*.*..****...................****.*..................****...................****8.*...**..........*..........***..**..**
.......***...................**..**.*..............*****.....................*.***....**..........**........***.*....***
........*........................**.**..............***.......................***.*...**.........***...........*......*.
