5 10
..1.......
.....*....
..........
*.........
........2*
